
AJ

1. 100

12.9.

appearace/look → vzhled
looks → dobrý vzhled
to edit oes past → změit ěčí miulost
car-jackig → úos auta
idecisive → erozhodý
badage → obvaz
backyard → zahrada
cheesy → laciý
to despise → opovrhovat
to row → veslovat
to hesitate → váhat
decade → desetiletí
sabre → šavle
to mug → přepadout z
whip → bič
auditio → kokurz
auxiliary verb → pomocé sloveso
box set → sada
udereath → zpod

17.9.

Who is Jack goig out with? → S kým chodí Jack?
What makes you happy? → Co tě čií šťastým?
I thought you'd be agry? → Myslel jsem, že budeš aštvaýá
Do you remember where I left my keys? → Vzpomíáš si, kde jsem echal své klíče?
Could you tell me, where the car park is? → �?eklla byste mi, kde je parkoviště?
subject → podmět
object → ředmět
whether/if → jestli/zda/pokud

21.9.

the latest/ewest → ejovější
bizarre → podivý
job seeker → uchazeč o práci
to thik o oe's feet → rychle reagovat
graduate → absolvet
merely → pouze
approach → přístup
demadig/challegig → áročý
to be straded → být uvízlý
desert → poušť
pioeer → průkopík
to cosider → považovat
to flap → mávat
to cluck → kvokat
ufortuate → eštěstí/ešťastý
recruitmet agecy → persoálí agetura
flustered → ervózí
to crush → rozdrtit
to perform → odvést výko
silico → křemík
cofidece → jistota/důvěra
job vacacy → prázdé pracoví místo

24.9.

a terraced house → řadový dům
to remember sth/somethig vividly → pamatovat si ěco živě
breeze → váek
to drag → vláčet
to carry o → pokračovat
to cotiue → pokračovat
curtai → zácloa
estate aget → realití makléř
to mistify → zmást
dome → kupole
bioculars → dalekohled
to glide → plachtit/klouzat
o the top of the hill → a vrchu kopce

26.9.

later → lucera
to sore → chrápat
to lurch → (kymácet se)/vrávorat
stirrig → ázaky
to flutter → třepotat
prize → prvotřídí
boar → divočák
bar → stodola
to exhibit → vystavovat
to regard → považovat
stout → zavalitý
to settle dow → usadit se
perch → bidlo
sill → parapet
to lie dow → lehout si
cart → vozík
hoof → kopyto
to coceal/hide → schovat se
foal → hříbě
mare → kobyla
paddork → výběh pro koě
orchard → sad

1.10.

igorace → ezalost
erve-rackig → mervy ztrhující
iapropriately → evhodě
bluder → houpá/hrubá chyba
beforehad → předem
to fiddle with → pohrávat si
to take a sip of → cucout si
iexcusable → eomluvitelý
prospective employer → poteciálí zaměstmavatel
stumped → zaraže
to maitai → udržovat
to make up → vymyslet si
by heart → azpaměť
o the outskirts → a předměstí
a old fried of mie → jede můj starý přítel
clairvoyat → věštec
fortue-tellig → věštěí
psychic → jasovidec
faith-healig → léčeí vírou
coicidece → áhoda


2. 100

8.10.

addict → arkoma
to glace at → mrkout
star sig → zameí zvěrokruhu
devoted etirely to → zcela věová/oddá
domestic → domácí/rodiý
to face → čelit
to cope with → vypořádat se
wellbeig → být si dobře
walk of life → společeské postaveí
to get o with → vycházet dobře s
to seek → vyhledávat
ufavourable → epřízivý
electio → volby
health issues → zdravotí problémy
obligatory → poviý
to draw up → vypracovatsestavit
to put up a tet → postavit sta
materity ward → porodické odděleí
delighted → potěše
to chage sth/somethig fot the better → změit k lepšímu
preseter → hlasatel
glamorous → úchvatý

10.10.

sigature → podpis
to reflect → odrážetodrazit
to evolve → vyviout
to pre'set → představit
'preset → současost/současý/dárek
to coicide with → střetout/setkat se
self → to já
iitial → prví písmeo
legible → čitelé
illegile → čitelé
to rise → růst
to desced → klesat
agle → úhel
I look forward to hearig from you. → Těším se, až tě uslyším.

15.10.

big-headed → amyšleý
bad-tempered → evrlýerudý
good-tempered → dobromyslý
ope mided → otevřeýliberálí
arrow-mided → úzkoprsí
abset-mided → duchem epřítomý
easy-goig → pohodový
dishearteed → sklíčeý/skleslý
laid-back → uvolěý
tight-fisted → lakomý
two-faced → pokrytecký
strog-willed → rozhodý
self-cetered → sobecký

17.10.

biographical → životopisý
recruitmet → ábor
departmet → odděleí
advisor → rádce
huma resources → lidské zdroje
ethusiastic about → adšeý z
sallary → plat
curriculum vitae → životopis
coverig/cover letter → motivačí dopis
to arrive o time → přijet přesě a čas

22.10.

Would you rather eat later? → Jedl bys později?
I'd rather ot do that. → Raději bych to edělal.
leadership → vedeí
to show/demostrate → ukázat
to start/commece/begi → začít
to see/view → ahlížet
to say/aouce → ozámit
shoes/footwear → obuv
to kow → být si vědom
to be aware of → být si vědom
aswer → odpověď
respose → odpověď
techical → odborý
techicia → techik
techique → techika
techology → techologie

29.10.

brood → sůžka
ducklig → káčátka
foreleg → předí oha
hid leg → zadí oha
a lump of sugar → kostka cukru
ribbo → stužka
to plait → splést
to purr → příst
to squeeze → vecpat/vymačkat
speech → proslov
to wader → toulat sebloumat
to tame → ochočit
rave → havra
throat → hrdlo
comrade → soudruh
to acquire → získat
stall → stáí
laborious → amáhavý
capable of → schopý
streght → síla/silý
to slaughter → porazit
hideous → hrozý
leisure → volý čas
slavery → otročia


3. 100

31.10.

to adhere to → dodržovat
to state → tvrdit
to purchase/buy → zakoupit
to termiate/fiish → dokočit
to verify → ověřit
to take o → zaměstatpřijmout
applicat → uchazeč
'record → zázam
to update → aktualizovatobovit
high-profile → ostře sledovaý
to play alog → spolupracovat
astoished → udiveý
spokesperso → mluvčí

2.11.

decet → obstojý
to dwell o/upo → omlývat
fertile → úrodý
abudace → hojost/adbytek
to ihabit → obývat
digity → důstojost
'produce → zemědělská produkce
ma → člověk
root → koře
to abolish → zrušit
calf → lýtko/tele
to till/cultivate → obdělávat
to drow → utopit
creature → stvořeí
dug → hojiva

5.11.

to choke → dusit se
to lea sb/somebody backwards → zakloit ěkoho dozadu
bur → popáleia
kitche film → potraviárská fólie
woud → ráa
to treat → ošetřit
ose bleed → krváceí z osu
to collapse → omdlít
to breathe → dýchat
breath → dech
to prevet → předcházet/zabráit
shoulder blade → lopatka
blockage → ucpáípřekážka
emergecy services → pohotovost
to swell → atéct
scar → jizva
clig film → potraviářská fólie
cloth → látkahadřík
to pich → přiskřípout/štípout
to tilt → akloit
airway → dýchací cesty
cushio → polštář
to straighte → arovat
ijury → zraěí
to ijure → zrait se

21.11.

to give first aid → dát prví pomoc
subur → spáleia
symptom → přízak
paracetamol → parale
o the Iteret → a iteretu
tumour → ádor
prompt → pobídutí
supplemet → áhražka/doplěk
I like fruit ad vegetables. → Mám rád ovoce a zeleiu.
to have a cold → být achlaze
to make a effort → vyaložit sahu
to blik → mrkout
to de'crease → sížit
'decrease → sížeiasížeí
to digest → strávit
furthermore → avíc
adequate → dostačující
fluid itake → příjem tekuti
caffeiated driks → kofeiové ápoje
to affect → postihovat
ushave hair → eoholeé vlasy
to questio → zpochybňovat
evidece → důkaz
to reveal → odhalit
to reiforce → posílit
trial → zkouškatestováí
to lack → postrádat
isufficiet → edostačující
dim → tlumeétemé
ophthalmologist → očí lékař
to disprove → vyvrátit
drowsiess → ospalost
miced beef → mleté hovězí

23.11.

to get rid of → zbavit se
straw → sláma/brčko
remaider → zbytek
victorious → vítězý
resolutio → odhodláí
determiatio → odhodláí
swift → rychlý
vote → hlasováí
vice → zlozvyk
to vaish → zmizet
sow → prasice
ifacy → raé dětství
hoarse → chraptivý
beast → zvířebestie
wheat → pšeice
barley → ječme
oats → oves
hay → seo
to low → bučet
to whie → kňučet
uproar → povyk
to bleat → mečet/bečet
to whiy → řehtat
to quak → kvákat
i successio → v řadě za sebou
pellet → brok
above all → především


4. 100

26.11.

ureliable → espolehlivé
out of date → po platosti/zastaralý
to discrimiate → rozlišovat
coditio → oemocěí
ufortuately → bohužel
sadly → bohužel
cofessio → dozáívyzáí
to feel uder the weather → cítit se pod psa
geeral practitioer → praktický lékař
heart rate → tepová frekvece
cosolatio → utišeí
obsessively → posedle
a worst-vase sceario → ejhorší případ
faulty → vadý
life-threateig → život ohrožující
to assume → předpokládat
ulcer → vřed
remedy → lék
blister → puchýř
herbal → byliý
maligat → zhoubý

5.12.

diagosis → diagóza
to look up iformatio about → ajít si o
eyesight → zrak
clumsy → emotorý
adveturous → dobrodružý
stubbor → tvrdohlavý
vulerable → zraitelý
wise → moudrý
to coform to → vyhovovat ěčemu
documetary → filmový dokumet
documet → papírový dokumet
wrikled ski → vrásčitá kůže
false teeth → falešé zuby
wig → paruka
cotact leses → kotaktí čočky
discomfort → epohodlí
discomfortable → epohodlý
to re'cord → ahrávka
to treat sb/somebody → chovat se k ěkomu
ivisibility → eviditelost
astoished → udiveý
to wolf-whistle → zahvízdat a žeu
to pay oe's fare → zaplatit ěčí jízdé
ote → bakovka
automatic teller machie → bakomat
cash machie → bakomat
to break dow → sesypat se
to be through → mít hodě za sebou
igorat → evědomost/evědomý
uethusiastic → eadšeý

10.12.

cardiga → svetřík
blazer → sako
chios → volější kalhoty
cyclig shorts → cyklistické kraťasy
The sweater does't fit me. → Svetr mi esede.
The blazer does't suit me. → Sako ke mě esedí.
The shirt matches my trousers. → Košile mi sede ke kalhotám.
to dress up → vyšvihout se
fur → kožich
hooded → s kapucí
lie → plátěý
loose → volý
plai → bez vzoru
pattered → se vzorem
striped → pruhovaý
suede → semiš
pale → bledýsvětlý
lycra → elastické
sleeveless → bez rukávu
deim → džíovia
waistcoat → vesta
velvet → samet
scruffy → ošutělý
to hag up → pověsit
to get udressed → svlékout se

14.12.

to bury → pohřbít
outlook o → pohled a
to take place → koat se
pre-emiet → čelí/předí
vivacious/lively → plý života
ivetive → vyalézavý
imble → hbitý/mrštý
a shrill voice → ostrýječivý hlas
persuasive → přesvědčivý
to elaborate → vypracovat
to expoud → vysvětlit
devoted to → oddaý ěčemu
meas → prostředek


5. 100

17.12.

eggog → vaječý likér
miced pie → bocháek s kousky ovoce
stable → stáj
crib → kolébka
chipolata → malý hubeý párek
bratwurst → klobása
codimet → ochucovadlo
horseradish → kře
Brussels sprout → růžičková kapusta
parsip → pastiák
turip → vodice
swede → tuří
sweet potato → batáty
Yule log → roláda
Yule → Váoce
log → dřevo
treacle/molasses → molase
to grid → mlít
trifle → typický ovocý desert
custard → vaječý krém
jelly → želé/rosol
spoge → piškot
purée → kaše/protlak
Christmas Eve → Štědrý večer
Christmas day → 25.12.
Boxig day → krabicový de
reideer → sob
spiderweb/cobweb → pavučia
festive → svátečí

11.1.

to couteract → potlačovat
tale → příběhpověst
to claim → tvrdit
clover → jetel
liseed → lěé semeo
capable → schopý
crust → kůrka
to eglect → zaedbávat
tormetor → mučitel
well → studa
to flig → hoditmrštit
to slam → bouchout
to be expelled → být vyhoze
boudary → hraice
at daw → za úsvitu
dew → rosa
pasture → pastvia
file → zástupřada
harvest → sklize�?
ualterable → ezměitelý
to od → kývout
udder → vemeo
ladder → žebřík

21.1.

to drift → být vzáše
vixe → semetrika
ultimate → ej-
fly → přitažlivý
to etice → alákat
by desig → úmyslě/záměrě
allurig → přitažlivýlákavýsvůdý
to tatalize → avadit
gifted → obdarovaýtaletovaý

25.1.

to hoist a flag → vztyčit vlajku
tablecloth → ubrus
flagstaff/flagpole → stožár
assembly → shromážděí
haress → postroj
resolutio → řešeí
to resolve → vyřešit
'object → předmět
to ob'ject → amítout
retirig age → důchodový věk
to put forward → předložit
blacksmithig → kovářství
carpeterig → tesařství
sparrow → vrabec
paw → tlapka
rubbish heap → hromada odpadu
forelock → ofia
mischief → rošťáctví
thoroughly → pečlivědůkladě
literate → gramotý
maxim → pravidlo
therefore → tudíž

4.2.

to require → požadovatvyžadovat
placebo effect → psychologický účiek léku
operatio → operace
surgery → operaceoperačí sál
operatig room/theatre → operačí sál
to measure → změřit
the public → veřejost
aaesthetic → umrtveí
limb → kočetia
drumbeat → bubováí
to reverberate/echo → odrážet/rozléhat/(zít ozvěou)
coferece room → zasedací místost
to maifest → projevit se
vitality → elá
simplistic → zjedodušeý
to udergo a surgery → podstoupit operaci
executive → řídící pracovík
glaucoma → zeleý zákal
sig laguage → zaková řeč
curret affairs → aktuálí události
uiqueess → jediečost
idispesible → epostradatelýezbytý
leggigs → legíy
garmet → oděv
accessory → doplěk
to make use of → využít ěčeho
to raid → aběhoutudělat ájezd
cupboard/cabiet/closet → skří�?
to alter → změitopravit
thread → it/vláko
craft → řemeslo
aversio → odpor
to be made up of → být tvoře z
to refer to → odkazovat se a
drawback → evýhoda
ich → palec
to mow → posekat
to rake → hrabat
cotet/satisfied → spokojeý


6. 100

8.2.

whelp → štěě
to whelp → vrhout
sturdy → bytelý/statý
to wea → odstavit
seclusio → ústraí/samota
to ripe → dozrát
widfall → padavka
to murmur → mručet
selfishess → sobectví
substace → látka/hmota
welfare → blahobyt
duty → poviost
to whisk his tail → švihat/kroutit ocasem

25.2.

i-flight → během letu
to be give istructios → dostat istrukce
to put o → připoutat se
to faste the seatbelt → připoutat se
seat tray → skládací stolek
the upright positio → vzpřímeá poloha
safety istructios → bezpečostí pokyy
aircraft → letadlo
to illumiate → rozsvítit
to tighte → utáhout
loose → volý
strap → pás
to release → uvolit
buckle → přeska
hadle → rukojeť
decompressio → ztráta tlaku
oxyge mask → kyslíková maska
firmly → pevě
to iflate → afoukout
crew → posádka
pouch → kapsa
to adjust → upravit
cord → š�?ůra
whistle → píšťalka

27.2.

demostratio → představeíukázka
laughable → směšý
despite → avzdory/přes
customs → celice
customs officer → celík
to walk off the plae → vystoupit z letadla
baggage reclaim → výdeja zavazadel
to smuggle → pašovat
shortage → edostatek
to request → požadovat
to lose cout of → ztratit přehled o
porter → osič
courtesy → slušost
bumpy → drkotavý
sick → špatě od žaludku
a log-haul flight → dálkový let
jet lag → pásmová emoc
aisle → ulička
to dropp off → odevzdat
boardig pass → palubí vstupeka
domestic flights → vitrostátí lety
departures board → tabule odletů

4.3.

air traffic cotroller → řídící letového provozu
programme → program
persoal qualities → osobostí vlastosti
slightly → epatrě/mírě
avigatio → plavba/avigace
stressful situatios arise → astávají stresové situace
predictable → předvídatelý
turbulece → turbulece

11.3.

icidet → příhodamimořádá událost
accidet → ehoda
paic broke out → vypukla paika
by accidet → ešťastou áhodou
route → trasa
emergecy aoucemet → ouzové hlášeí
arrative → vyprávěcí
disruptio → arušeí
shift → pracoví směa
to tur/show up → ukázatobjevit se
to embark the plae → astoupit do letadla
to disembark the plae → vystoupit z letadla


7. 100

25.3.

aecdote → příběhhistorka
brave → odvážý
brace for 'impact → připravte se a dopad
ferry → přívoz/trajekt
fiacée → soubekyě
fiacé → soubeec
coectig flight → spojový/ávazý let
cardiologist → kardiolog
to put out a call → spustit hlášeí
(i the ed)/evetually/ultimately → akoec
fially → akoeckoečěkoečě
fially → akoeckoečěkoečě

27.3.

geeratio gap → geeračí propast
revege → odplata
to cotribute → přispět
target → cíl
to se out to do sth/somethig → rozhodout se udělat ěcozamýšlet
I'm fed up. → Mám toho dost.
to stab → bodout
brake → brzda
cofrotatio → střetkoflikt
fratic → šíleýbezsebe
fabulous → úžasý
itake → příjem kalorií/cukru
adverb → příslovce
adverbial → příslovečé určeí
maer → způsob
obviously → očividě
apparetly → očividě

26.4.I

straightaway/immediately → okamžitě
a bumpy flight → kodrcavý let
Please arrive o time. → Prosím přijeďte včas.
He arrived i time for supper. → Přijel včas a večeři.
hard → tvrdý/tvrdě
hardly/barely/scarcely → sotva/stěží
Those were his actual words. → To byla jeho vlastí slova.
the curret ecoomic policy → současá ekoomická strategie
At the 'preset time we have o explaatio for this. → Mometálě pro to emáme vysvětleí.
comic /book → komiks
academic joural → vědecký časopis
ovel → romá
ovella → ovela
short story → povídka
classic → (dílo klasické literatury)/káo
website → webové stráky
web page → webová stráka
webpage → webová stráka
work-related articles → čláky zaměřeé a práci
Which of the above do you read? → Které z výše uvedeých čteš?
We played cards to pass the time. → Hráli jsme karty, abychom zabili čas.

26.4.II

queue → řada
lie → řada
to cofiscate → zabavit
departure louge → odletová hala
the weather over the At'latic → počasí ad Atlatikem
emergecy ladig → ouzové přistáí
It's importat to get thigs dow o paper. → Je důležité si zapsat věci a papír.
(a staff member)/(a member of staff)/employee → čle persoálu
romace → milostý příběhromáek
otebook → zápisíkmeší počítačzápisíkmeší počítač
otebook → zápisíkmeší počítačzápisíkmeší počítač
otebook computer → meší počítač
laptop /computer → větší počítač
distractio → rozptýleí
plot → zápletka
I keep to this routie every day without variatio. → Dodržuji tuto rutiu každý de bez obměy.
repetitio → opakováí
state of mid → duševí rozpoložeí
to write by had → psát ručě
ballpoit → kuličkové pero
to reveal oe's secret → odhalit ěčí tajemství

26.4.III

We welcome ay costructive criticism. → Vítáme jakoukoli kostruktiví kritiku.
I'm well. → Mám se dobře.
half /of the coutry → půl státu
to migle → bavit se s moha lidmi
to tur sb/somebody out → vyhodit ěkoho
rebelliousess → vzdorovitost/vzpurost
savage → divošský/surový
to devour → zhltout
pail/bucket → kyblík
rage → zuřivostzlost
cotemptible → opovržeí hodý
Pigeos cooed i the elms. → Holuby vrkali a jílmech.
di → hlukrámus
prophecy → proroctví
doom → zkáza
to try → pokusit se
to attempt → pokusit se
to be i charge of → mít a starostiříditvést

29.4.I

rumour → fáma/zvěst
distorted → zkresleý/překrouceý
vicios → krutýbrutálí
skirmish → šarvátka/potyčka
to lash → bičovat
to squeal → ječet
to retreat → stáhout seustoupit
cowshed → kraví
stallio → hřebec
lad → klukchlapec
skull → lebka
vegeace/revege → odplata/msta
claw → dráp
to make a bolt for it → vzít rohautéct
to peck → klovat
horseshoe → podkova
sorrowfully → žalostěsmutě
setimetality → přílišá citlivost
The gu wet of. → Ze zbraě vyšla ráa.
to dash → řítit se


8. 100

29.4.II

impromptu → improvizovaý
uaimously → jedomyslě/jedoduše
brass → mosaz
ambush → útok ze zálohy
cartridge → patroy/áboje
upcomig → adcházející
seior prak → posledí zvoěí
water pistol → vodí pistole
dreched → promáčeý
to ditch a class → zatáhout hodiu
cocky → amyšleýarogatí
coy → plachý
to make out with → muchlovat se s ěkým
the baddest → ejlepší
to be i demad → být žádaý
o top of that → avíc
smacker → dolar/libra
savigs → úspory
get-together → schůzka
half a hour → půl hodiy
freshma → prvák
sophomore → druhák
juior → třeťák
seior → čtvrťák
to reek → smrdět

3.5.

I had toast ad coffee for breakfast. → Měl jsem k sídai toast a kafe.
I saw her this morig at breakfast. → Viděl jsem ji des ráo u sídaě.
shootig rage → střelice
delight → potěšeí
parkig lot → parkoviště
car park → parkoviště
wallet → peěžeka
purse → peěžekakabelkakabelka
purse → peěžekakabelkakabelka
hadbag → kabelka
icredulously → evěřícě
exaggeratio → zvětšováí
muggig → loupežé přepadeí
trigger → spoušť
to approve → schválitsouhlasit
self-defece → sebeobraa
self-defese → sebeobraa
movie-goer → ávštěvík kia
ciema-goer → ávštěvík kia
a shadowed face → zastíěý obličej
obstacle → překážka

6.5.

The data is/are summarized i table 5. → Data jsou shruta v tabulce 5.
to do sth/somethig o impulse → udělat ěco spotáě
resistace → odporvzdor
to up'grade → vylepšit
'upgrade → vylepšeí
to sur'vey → dělat průzkum
'survey → výzkumaketa
biographical → životopisý
book cover → obal kihy
editor → šéfredaktor
the committee chair → předseda výboru/komise
i recogitio of → jako projev uzáí za
She was awarded the prize i recogitio of her outstadig cotributio to the project. → Byla jí udělea cea jako projev uzáí za její mimořádý příspěvek projektu.
scarlet → rudá
prairie → prérie
at the ed of a log day → a koci dlouhého de
trilogy → trilogie
stamia → výdrž
cotemporary → současýmoderí
moder → současýmoderí
trivial → bezvýzamý
to read for pleasure → číst pro potěšeí
to carve out time → vybojovat/získat si čas
prejudice → předsudek
to dwigle → zmešitsížitscvrkout se
o/i the high street → a hlaví třídě
They regard Edith as eccetric. → Považují Edith za výstředí.
Are youg people embracig the ew techology? → Používají mladí lidé ové techologie?
to bear i mid → mít a paměti
o a regular basis → běžě
to possess → vlastit

1.6.

guilt → via
towel → hlučý
questioaire → dotazík
to commit a crime → spáchat trestý či
Evets are held worldwide. → Události se koají celosvětově.
to i'crease awareess ad appreciatio of the eviromet → zvýšit povědomí a oceěí životího prostředí
si → hřích
coveiet → praktický/výhodý/vhodý
to drow → topit se
a reusable shoppig bag → zovu použitelá ákupí taška
I ofte forget to brig my shoppig bag with me. → Často zapomíám vzít si s sebou svou ákupí tašku.
to brush/clea oe's teeth → vyčistit ěčí zuby
orgaic food → bio strava
to pollute → zečistit
I ca't afford to buy a car. → Nemohu si dovolit koupit auto.
to istall solar paels → amotovat solárí paely
to cut dow trees → kácet stromy
wid turbie → větrá turbía
to geerate/produce electricity → vyrábět elektřiu
desaliatio plat → odsolovací staice
i advace → v předstihu
temperatures rise → teploty se zvyšují
heatwave → vla veder
to break the speed limit → překročit povoleou rychlost
to take out isurace → vzít si pojištěí
to arrive at the last miute → přijet a posledí miutu
'cotract → smlouva
to cheat i a exam → podvádět při testu
to revise for a exam → opakovat si a test
to cosider oeself a risk taker → považovat se za riskujícího člověka

2.6.

ed-of-September temperatures → teploty koce září
delight → potěšeí
threat → hrozba
earestly → vážě
to occur → stát/přihodit se
to happe → stát/přihodit se
a warm spell i autum → teplé období a podzim
feast → hostia
foggy → mlhavý
hadwritig → rukopis
a itrisically iterestig topic → v podstatě zajímavé téma
to facilitate social iteractio → zjedodušit sociálí komuikaci
obsessio → posedlost
reluctat → váhavý
cofessio → vyzáíodpustek
ifluetial → vlivý
precipice → sráz
to affect your mood → ovliv�?ovat tvou áladu
It poured with rai days after days. → Lilo dy a dy.
You were caught outside i a thuderstorm. → Chytil jsi veku bouřku.
to protect oeself from the weather → chráit se před počasím
parachute jump → skok s padákem
hairstyle/hairdo → účes
zebra/pedestria crossig → přechod pro chodce
crosswalk → přechod pro chodce
golf course → golfové hřiště
Hurricaes ad floods are frequet occirreces. → Hurikáy a povodě jsou častými případy.
Idia summer → babí léto
school curriculum → školí osovy
to observe → pozorovatsledovat
to be i haste/hurry → pospíchat
weather forecast → předpověď počasí
bright → jaso
dull → zatažeo
temperature soared to 29°C → teploty vylétly a 29°C


9. 100

3.6.

persoal safety → osobí bezpečost
to hitchhike → jet stopem
to call off → zrušit
to cacel → zrušit
first aid kit → krabičla prví pomoco
to uplug a electrical appliace → (od/vy)pojit elektrický spotřebič
hairdryer → fé a vlasy
speedig driver → příliš rychle jedoucí řidič
buzz → šum
itoxicatig → uchvacující/omamující
doze → tucet
to admit → přizat/dozat
lecturer → předášející učitel
motorcyclist → motorkář
a habitual offeder → otorický pachatel
sesatio-seakig → vyhledáváí zážitků/sezací
fatal cosequeces → smrtelé ásledky
a kee biker → zapáleý cyklista/motocyklista
ivestigator → vyšetřovatel
They rage i age from 18 to mid-forties. → Jsou ve věku od 18 do čtyřicátíků.
to get straight to the poit → jít přímo k věci
vehicle → vozidlo
vulerability → zraitelost
assessmet → posudekzhodoceí
pedestria → chodec
to take sth/somethig very seriously → brát ěco velmi vážě
i a few weeks' time → za ěkolik málo týdů
to fall asleep at the wheel → usout za volatem
a log-distace jourey → dlouhá cesta
motorway/expressway/freeway/highway → dálice
iterstate → dálice
to take out isurace → vzít si pojištěí

4.6.

to take sth/somethig ito accout → vzít v potaz
to take after → podobat se
to take off → svlécivzlétout
to take up → začít s
for example/istace → apříklad
acroym → zkratka - prví písmea
abbreviatio → zkratka - zkráceé slovo
What does FBI stad for? → Co zameá FBI?
the Federal Bureau of Ivestigatio → federálí policie USA
the Cetral Itelligece Agecy → (bezpečostí iformačí služby)/(tajá policie)
to deter → odradit/odstrašit
thrill-seeker → hledač vzrušeí
a primal urge → základí/(sobě vlastí) utkáí
to leap/jump/hop → skočit
a hadful of people → hrstka lidí
elite → elita
to put oe's life at risk → ohrozit ěčí život
to pursue his/her dreams → jít si za svým sem
to push the boudaries of what humas ca do → posuout hraice lidských možostí
bad ecoomic performace → špatý ekoomický výko
to make a real hash of sth/somethig → totálě ěco podělat
Math bores me o ed. → Matika mě příšerě udí.
to go halves o sth/somethig → jít apůl
to fluk/fail → ezvládout/zvorat
itoxicated/excited/exhilarated → atěšeý/uchváceý
to grump → stěžovat siremcat
to complai → stěžovat siremcat
(wor out)/exhausted → vyčerpaý/strhaý
to pamper/spoil → rozmazlovat
to sack out → jít spát/chrět
to go to sleep → jít spát/chrět
tedious → otravé/udé
borig → otravé/udé
I'm all ears. → Jsem jedo ucho.
I could eat a horse. → Mám hlad jako vlk.
to zoe out → přestat vímatodpojit se
to stop payig attetio → přestat vímatodpojit se
hash brows → bramborové placky


18.10.

to 'paic → paikařit
hys'terical → hysterický
to act coolly → jedat klidě
to carry o readig a book → pokračovat ve čteí kihy
phoe coverage → mobilí pokrytí
itruder → vetřelec
crisis → krize
crises → krize
over'whelmed → přehlce
isolvable → evyřešitelý/eřešitelý
isoluble → evyřešitelý/eřešitelý
to over'come a feelig → překoat pocit
'avalache → lavia
the Ades → Ady

13.3.I

coutability → počitatelost
We do't get much homework. → Nedostáváme hodě domácích úkolů.
I have three homework assigmets to do for tomorrow. → Na zítřek mám tři domácí úkoly.
My father gave me some good advice. → Můj táta mi dal dobrou radu.
There is some beautiful old furiture i the house. → V domě se achází pěký starý ábytek.
Some of their baggage/luggage was stole. → Některá jejich zavazadla byla ukradea.
That's good ews. → To (je dobrá zpráva)/(jsou dobré zprávy).
I eed some iformatio about hotels. → Potřebuji iformace o hotelech.
They clambered over the slippery rocks. → (Škrábali se)/Šplhali přes kluzké kamey.
Mathematics is too difficult for me. → Matematika je pro mě příliš obtížá.
Measles is i most cases a harmless illess. → Spaličky ejsou ve většiě případů ebezpečá emoc.
Checkers/Draughts is more fu tha billiards for me. → Dáme je pro mě větší zábava ež kulečík.
A epidemic of measles, mumps ad rubella/(Germa measles) is ow possible. → Je možá epidemie spaliček, příušic a zarděek.
Rabies is almost always fatal if ot treated early. → Vzteklia je téměř vždy smrtelá, pokud se eléčí brzy.
Shigles is caused by the same virus as chickepox. → Pásový opar je způsobe stejým virem, jako plaé eštovice.
Prevetio is better tha cure. → Prevece je lepší, ež léčba.
They fially have iveted a cure for cacer. → Koečě vyalezli lék a rakoviu.
He has little experiece i bussiess. → Má málo zkušeostí s obchodováím.
I had a iterestig experiece o holiday. → Na dovoleé jsem měl zajímavou zkušeost.
Glass is fragile. → Sklo je křehké.

13.3.II

I would like a glass of water. → Chtěl bych skleici vody.
She has black hair. → Má čeré vlasy.
There's a hair i my soup. → V mé polévce je vlas/chlup.
Some products are made of iro. → Některé výrobky jsou vyrobey ze železa.
I eed a ew iro. → Potřebuji ovou žehličku.
I'm goid to buy a paper. → Koupím oviy.
I eed to buy some paper. → Potřebuji koupit papír.
Brigig up childre well is hard work. → Vychovat dobře děti je těžká práce.
Threr works of art were stole. → Tři umělecká díla byla ukradea.
There were packets of deterget o the table. → Na stole byla baleí čistících prostředků.
All my clothes are packed. → Všecho moje oblečeí je zabaleo.
He took oly a small bag with a chage of clothes/clothig. → Vzal si je malou tašku s věcmi a převlečeí.
Police foud (a piece)/(a item) of clothig i the bushes. → Policie ašla kus oblečeí v křoví.
I stripped off my pyjamas/pajamas ad put them ito the rucksack. → Svlékla jsem si pyžamo a dala ho do batohu.
She was pluckig her eyebrows with a pair of tweezers. → Trhala si obočí pizetou.
Had me that pair of pliers, please. → Podej mi, prosím, ty kombiačky.
The bathroom scales are broke. → Osobí váha je rozbitá.
The isurace compay offers may travel isurace plas. → Pojišťova abízí moho balíčků cestovího pojištěí.
I've spilled the coffee. Ca you had me a cloth to wipe it up? → Rozlil jsem kávu. Můžeš mi podat hadřík, abych to utřel?
Let me see if we have a vacacy for toight. → Podívám se, jestli máme volý pokoj a deší oc.

13.3.III

He eeds to lear to cotrol his temper. → Potřebuje/Musí se aučit ovládat svoji vzětlivou povahu.
a upbeat message → povzbudivá zpráva
mourful music → smutá/truchlivá hudba
I hardly ever go to live cocerts. → (Sotva kdy chodím)/(Téměř ikdy echodím) a kocerty živé hudby.
I decided to take up playig the piao. → Rozhodla jsem se začít hrát a klavír.
They're the bad's two roadies. → Oi jsou ti dva bedňáci kapely.
We have a gig i L.A. o Thursday. → Máme ve čtvrtek kocert v L.A.
It causes relatioships to break dow. → Způsobuje to, že se hroutí vztahy.
They wet behid my back. → Udělali to za mými zády.
We idulged i some ice cream sudaes. → Dopřáli jsme si zmrzliové poháry.
The whole sorry affair became a vicious circle. → Celá ta žalostá kauza se stala bludým kruhem.
The committee is made up of represetatives of every state. → Komise je složea y poslaců každého státu.
The burglars have tured our house upside dow. → Lupiči převrátili áš dům vzhůru ohama.
a rehearsal for Romeo ad Juliet → /divadelí zkouška a Romea a Julii
He was physically strog ad metally agile. → Byl tělesě zdatý a metálě čilý.
a fitess regime → režim kodičího cvičeí
stretchig exercises → protahovací cviky
The two words are almost iterchageable. → Ta slova jsou téměř zaměitelá.
Childre eed moral guidace. → Děti potřebují morálí vedeí.
He loged to see her agai. → Toužil ji zovu vidět.

13.3.IV

It attracts tourists ad risk-takers alike. → Přitahuje to turisty stejě jako riskéry.
hammock → houpací síť
the moutai summit → vrchol hory
Fast-food restaurats are sprigig up all over tow. → Restaurace rychlého občerstveí se vyořují po celém městě.
The dace troupe is doig a iterestig piece. → Taečí soubor předvádí zajímavý kousek.
He holds strog opiios o these issues, → Zastává silé ázory a tyto záležitosti.
Life is ever dull whe thez are here. → Život eí ikdy udý/ezáživý, když jsou tady.
Do't just sit back ad wait for ew busiess to come to you. → Prostě jeom eseď a ečekej, až ový byzys přijde za tebou.
She must have moey to bur. → Musí mít peěy jak želez.
The bad will be i debt to the record compay for years. → Skupia bude roky zadlužea vůči ahrávací společosti.
I ca't buy you this, I'm ot made of moey. →  Nemůžu ti to koupit, ejsem tiskára a peíze.
a atio with high stadard of livig → stát/árod s vysokým životím stadardem
Moey is tight. → Peěz bylo málo.
a uhealthy obsessio with beig thi → ezdravá posedlost být hubeým
You should ot udertake a log jourey if you are uwell. → Neměl bys podikat dlouhou cestu, když jsi emocý.
No oe has attemtep this experimet before. → Nikdo předtím ezkusil teto experimet.
outrageous prices → ehorázé cey
to carry out → provést výzkum
cocuct a survey → provést výzkum
May studets pass without ay real egagemet i learig. → Moho studetů uspěje bez skutečého zapojeí se do učeí.
the pursuit of happiess → hledáí/usilováí o štěstí

13.3.V

flipper → potapěčská ploutev
charities that aid families i distress → charity, které pomáhají rodiám v ouzi
code of coduct → pravidla chováí
The police have foud a vital piece of evidece. → Policie ašla důležitý důkaz.
to ward off dager → odvrátit ebezpečí
The statemets cotradict each other. → Tvrzeí si odporují.
The strap is geuie leather. → Pásek je ze skutečé kůže.
four times i a row → čtyřikrát v řadě /(za sebou)
to brig up the subject of moey → adhodit téma peěz
He was brought up by his gradparets. → Byl vychová svými prarodiči.
Emplyees are permitted to work from home. → Zaměstacům je dovoleo pracovat z domova.
a would-be actor → ěkdo sažící se být hercem
Virtually/Practically all the childre come to school by bus. → V podstatě všechy děti přijely do školy autobusem.
a stack of papers → stoh papírů
It's just/oly a matter of time. → Je to pouze otázka času.
to have a very positive attitude to life → mít velmi pozitiví přístup k životu
It's worth checkig the details of the cotract before you sig it. → Vyplatí se zkotrolovat podrobosti smlouvy předtím, ež ji podepíšete.
That sog always remids me of our first date. → Ta píseň mi vždy připomíá aše prví rade.
fad → přechodá módarychlokvaška
That's ludicrous/ridiculous! → To je směšé!

13.3.VI

They regard it as siful. → Považují to za hříšé.
She graduated from uiversity. → Absolvovala uiverzití studia.
There's o poit i talkig to him. → Nemá ceu s ím mluvit.
She must be lyig to us. → Určitě ám lže.
She deied takig the moey. → Popřela, že vzala ty peíze.
Do't forget to lock up the warehouse. → Nezapomeň zamkout sklad.
supermatural powers → adpřirozeé síly
a grippig story → poutavý příběh
a flaw i the software → vada v softwaru
to be at a loss → být v rozpacích
itese pressure → silý tlak
The film reaches its climax i the fial scee. → Film dosahuje vrcholu v posledí scéě.
to be good at typig → být dobrý v psaí a klávesici
The sea was rough. → Moře bylo rozbouřeé.
I do't ear a huge salary, but we get by. → Nevydělám obrovský plat, ale (vystačíme si)/vyžijeme.
The police are ivestigatig the icidet. → Policie vyšetřuje událost.
to chage your midset → změit (svůj způsob myšleí)/ázory
Kids are all proe to eat juk food. → Děti mají skloy jíst ezdravé jídlo.
Try to look o the bright side. → Saž se dívat a tu pozitiví (stráku věci)/stráku.
I've set the alarm clock to go off at 7 am. → Nastavil jsem budík, aby se spustil v 7 ráo.

13.3.VII

decay orgaic matter → (rozkládající se)/tlící orgaická hmota
I heard the birds twitter. → Slyšel jsem ptáky cvrlikat.
a teis racket/racquet → teisová raketa
sleet → déšť se sěhem
evious → závistivý
quarry → kameolom
sowdrift → sěhová závěj
They caught a glimpse of a dark gree car. → Zahlédli tmavě zeleé auto.
timber/lumber → stavebí dřevo
The puppy was gawig o a boe. → Štěě ohlodávalo kost.
The drai was blocked up. → Odtok byl ucpaý.
to siff → čichat/očichat
meace/threat → výhružka
vaity → domýšlivost
traitor → zrádce
We were frisked at the airport. → Byli jsme prohledái a letišti.
to lurk → číhat
All colour draied from her couteace. → Veškerá barva vymizela z jejího obličeje.
bruise → modřia
He cofessed to beig a spy for the KGB. → Přizal, že byl špioem KGB.

13.3.VIII

The lyrics were't very good. → Text písě ebyl velmi dobrý.
(Beat it)/(Get lost)! → Zmiz/Vypadi!
to defeat → porazit
disapproval → esouhlas/odmítáí
to show off → machrovat
verse/staza → odstavec v písi/bási
lie → verš
Our car's gas tak is almost empty. → Nádrž ašeho auta je téměř prázdá.
low-fat foods → ízkotučé potraviy
I'm out of shape ad wat to lose weight. → Nejsem ve formě a chci shodit a váze.
pey → cet
ickel → pět cetů
dime → deset cetů
quarter → 25 cetů
lewd → obscéí/oplzlý
Liste up! → Poslyš!
I've had it up to here with you. → Mám toho s tebou po krk.
What do you have to say for yourself? → Co mi a to řekeš?
to pop a bottle → práskout láhev
to make out → muchlat se

13.3.IX

to be i the spotlight → být středem pozorosti
rafters → krov
buck → dolar
whip → auťák
to black out → omdlít
to throw up → zvracet
to (have a hissy fit)/throw → šílet/(mít rapla)
tatrum → šílet/(mít rapla)
to sip → srkat/usrkávat/pocucávat
beer o tap → čepovaé pivo
dilliget → pilý
i advace → dopředu
to flick/flip/sap/put/tur the light o → zapout světlo
to flick/flip/sap/switch/tur the light off → vypout světlo
cotagious → akažlivý
libido/(sex drive) → sexuálí pud
to load/stock up o → udělat zásoby čeho
self-cofidet → sebevědomý
self-esteem → sebeúcta/hrdost
self-coscious → esmělý/(stydící se)
self-actualizatio → seberealizace

13.3.X

self-employed → samostatě výdělečě čiýa volé oze
self-idulget → požitkářský - egativě
self-reliat → soběstačý
self-opiioated → samolibý
humidity → vlhkost
soakig wet → úplě promočeý
specime → exemplář/jediec/vzorek
a lea body → štíhlá postava
to take off → vzlétout
a crack of thuder → zahřměí
warmth → teplo
to rip off buttos → urvat koflíky
mea → zlý/krutý/podlý
to rearrage → přeskupit
a flash of lightig → zableskutí
to edager → ohrozit
mosquito → komár
a chroic coditio → chroické oemocěí
loss → ztráta
a dager zoe → zóa ebezpečí

13.3.XI

to uriate → močit
The headmaster threateed the boys with expulsio. → Ředitel pohrozil chlapcům vyloučeím.
to assemble → shromáždit se
disobediece → eposlušost
executio → poprava
Rosie started i disbelief. → Rosie evěřícě zírala.
the story of a woma who plots revege → příběh žey, která kuje pomstu
to commit suicide → spáchat sebevraždu
attempts to discourage illegal immigratio → pokusy odvrátit lidi od elegálí imigrace
paymet → platba
pale → bledý
a cociliatory message → smířlivá zpráva
to deafe → ohlušit
cotemptible → zavržeíhodý
partially/partly → částečě
Cut ay excess fat from the meat. → Odřežte adbytečý tuk z masa.
poultry → drůbež
Do you get a allowace for clothes? → Dostáváš příspěvek a oblečeí?
hauch → kýta

13.3.XII

a woode chest → dřevěá beda
Ia came gallopig dow the stairs. → Ia /rychle seběhl schody.
va → dodávka
limb → kočetia
brut → surovec
He's merely a boy - you ca't expect him to uderstad. → Je to je malý kluk - emůžeš očekávat, že to pochopí.
idigat → pobouřeý/rozhořčeý
(veteriary surgeo)/vet → veteriář
stiff i the joits → ztuhlé klouby
to geerate electrical power → vyrábět elektrickou eergii
a electrical appliace → elektrický spotřebič
electric curret → elektrický proud
electric guitar → elektrická kytara
Visitors to Rome marvel over the beauty of the city. → Návštěvíci Říma žasou ad krásou tohoto města.
birch → bříza
He rarely cosets to do iterviews. → Zřídka dává souhlas k rozhovorům.
They burst ito laughter. → Vyprskli smíchy.
a taste that ligers i your mouth → chuť, která přetrvává v ústech
blackcurrat → čerý rybíz
redcurrat → červeý rybíz

13.3.XIII

a outlet for stress → vetil a stres
to pass the time → krátit si čas
the oset of witer → počátek zimy
She was far too immersed ii her studies. → Byla přespříliš zabraá do svých studií.
reigig champio → úřadující mistr
Make it sappy! → Pohi sebou!
Other coutries are preparig to follow suit. → Ostatí státy se chystají udělat totéž.
Aother area that warrats atetio is that of fudig for uiversities. → Další oblast, která si vyžaduje pozosort, je fiacováí uiverzit.
a radius o 40 miles → dosah 40 mil
a sece of ormalcy → pocit ormálosti
pademic → pademie
Flu is most prevelat durig the witer moths. → Chřipka je ejběžější v průběhu zimích měsíců.
to distiguish → rozlišovat
compulsory educatio → poviá školí docházka§
to erol i college → zapsat se a uiverzitu
blue-collar job → mauálí zaměstáí
white-collar job → kacelářská zaměstáí
vocatioal traiig → učeí
bachelor's degree → bakalářský titul
master's degree → magisterský titul

17.2.I

glossary → slovíček
What did she do afterwards? → Co udělala poté?
terraced house → řadový dům
A youg couple live i the house o our right. → Mladý pár žije v domě po aší pravé straě.
to drag → vláčet/táhout
I’ll complai to the police tomorrow. → Zítra si budu stěžovat policii.
to carry o → pokračovat
to go to sleep → jít spát
to rig the doorbell → zazvoit a domoví zvoek
estate aget → realití makléř
to be mystified → vůbec echápat
cloth → látka
dishcloth → hadr a umýváí ádobí
dish towel → utěrka
kitche towel → papírová utěrka
tablecloth → ubrus
clothes → oblečeí
to clothe → obléci
to remember sth vividly → pamatovat si ěco jasě
breeze → váek

17.2.II

o the top of the hill → a vrcholu kopce
dome → kupole
bioculars → dvouoký dalekohled
frighteed → vyděšeý
to stare at sth → zírat a ěco
to glide → plachtit/(klouzat vzduchem)
object → předmět
to halluciate → blouzit
What was the weather like? → Jaké bylo počasí?
o the outskirts of Istabul → a předměstí Istabulu
a old fried of mie → můj starý přítel
The three of us had a pleasat dier together. → Společě jsme všichi tři příjemě povečeřeli.
to refuse → odmítout
clairvoyat, psychic → jasovidec
fortue-teller → věštec
accurate → přesý/precizí
How does he feel about the experiece? → Co si myslí o té zkušeosti?
spot-o → aprosto/dokoale přesý
laid-back, easy-goig → pohodový/uvolěý
coicidece → áhoda/(shoda okolostí)

17.2.III

spooky → strašidelý
coffee grouds → lógr
as far as I kow  → pokud vím
a ejoyable eveig → příjemý večer
to relieve → ulevit
A shiver ra dow my spie. → Mráz mi přejel po zádech.
explaatio → vysvětleí
UFO/(uidetified flyig object) → UFO
faith healig → léčeí vírou
bizarre/odd/strage → divý/zvláští
emphasis → důraz
to be good at laguages → být dobrý v jazycích
to look forward to -ig → těšit se a -kocovka
to sig → podepsat
sigature  → podpis
extract → výňatek/úryvek
hadwritig → rukopis
to evolve as a perso → vyvíjet se jako jediec
clue → klíč/vodítko
astrology → astrologie

17.2.IV

my true self → mé pravvé já
iitials → iiciály
legible/readable → čitelý
illegible/ureadable → ečitelý
to desced → klesat
horizotal → vodorový
agle → úhel
to cosist of → skládat se z
secretive → tajůstkářský
protective → ochraý/ochraářský
self-esteem → sebeúcta/hrdost
promiet → výzačý/předí
isecure → ejistý
objective/goal/aim → cíl
disorgaized → ezorgaizovaý
idecisive → erozhodý
assertive → asertiví
to face problems → čelit problémům
to overcome problems → překoat problémy

17.2.V

determied → odhodlaý
dishearteed → sklíčeý/skleslý
depressed → deprimovaý
to idicate → azačovat/ukazovat
emotioally stable → emocioálě stabilí
to bear i mid → mít a paměti
compoud → složeia/sloučeia
big-headed → amyšleý/afoukaý
self-cofidet → sebevědomý
well-balaced → vyrovaý
bad-tempered → evrlý/mrzutý
good-tempered → přátelský, dobromyslý
ope-mided → otevřeý
arrow-mided → úzkoprsý
abset-mided → duchem epřítomý
tight-fisted → lakomý
two-faced → pokrytecký
strog-willed → houževatý/rozhodý
self-cetred → sebestředý
biographical → životopisý

17.2.VI

HR/(huma resources) departmet → persoálí odděleí
recruitmet advisor → poradce pro ábor zaměstaců
ethusiastic about  → adšeý z
salary → plat
CV/(curriculum vitae) → životopis
cover/coverig letter → motivačí dopis
to dress appropriately → obléci se vhodě
to arrive o time → dorazit a čas
abbreviatio → zkratka
to apply for a job → žádat o práci
cadidate → uchazeč
behaviour → chováí
blazer → sako (sportoví)
purpose → účel
o several occasios  → při ěkolika příležitostech
commuicatio skills → komuikačí dovedosti
leadership → vedeí schopost vést
ethusiasm → adšeí
to collect/(pick up) sb from receptio → vyzvedout ěkoho a recepci
to greet sb i a friedly maer → ěkoho přátelsky pozdravit

17.2.VII

Questios ca be related to aythig. → Otázky se mohou týkat čehokoliv.
to ecourage sb → povzbudit ěkoho
employmet  → zaměstáí
hoest → upřímý
job advert → pracoví izerát
criterio → kritérium
post → pozice (v zaměstáí)
career → kariéra
obviously → očividě
applicatio → žádost
to show/demostrate → ukázat
to begi/start/commece → začít
to see/view sth egatively → ěco egativě vímat
to state → tvrdit
footwear → obuv
suitable/appropriate → vhodý
to be aware of → být si vědom
aswer/respose → odpověď
to assess → ohodotit
the last time → aposled

17.2.VIII

remedy → lék
Did the iterview go well? → Šlo to a pohovoru dobře?
Whe did you last have a iterview for a job? → Kdy jsi měl aposled pohovor do zaměstáí?
job descriptio → (popis práce)/(pracoví áplň)
opportuity → příležitost
research → výzkum
to research → zkoumat
philosophy → filozofie
I evetually got the job. → Nakoec jsem práci získal.
cotets → obsah
to hire → zaměstat
ijury → zraěí
to choke/suffocate → dusit (se)
to lea backwards → ahout se dozadu
(kitche/clig film)/(plastic wrap) → potraviářská folie
to bleed → krvácet
to press o the woud → tlačit a ráu
to treat a ose bleed → ošetřit krváceí z osu
to pich → štípout/(/při)skřípout
to collapse  → zhroutit se

17.2.IX

to breathe → dýchat
breath → dech
to prevet uecessary movemet → zabráit zbytečému pohybu
badage → obvaz
plaster/Bad-Aid → áplast
to ache/hurt → bolet
rash → vyrážka
ucoscious → v bezvědomí
atibiotics → atibiotika
medicie → lék
operatio/surgery → operace, zákrok
X-ray → retge
ijectio → ijekce
syrige/hypodermic → ijekčí stříkačka
symptom → přízak
emergecy → aléhavý případ,k stav ouze
aspiri → aspiri
paracetamol → Parale
cholesterol → cholesterol
to give first aid → dát prví pomoc

17.2.X

to be stug by a wasp → být bodut vosou
to have subur → spálit se slucem
sustroke → úžeh
heatstroke → úpal
a brai tumour → ádor a mozku
a blood test → kreví test
vitami supplemet → vitamíové doplňky
earache → bolest uší
toothache → bolest zubu
to vomit/(throw up) → zvracet
to be sick → zvracet/(být emoce)
to be sick to oe's stomach → zvracet
to seeze → kýchat
a sore throat → bolest v krku
diarrhoea → průjem
to fait/(pass out) → omdlít
blister → puchýř
to have a cold → být achlaze
to have flue → mít chřipku
to feel dizzy → mít závrať

17.2.XI

He aches all over. → Bolí ho celé tělo.
to swallow  → polykat
to lose cosciousess → ztratit vědomí
He feel that he’s goig to vomit. → Chce se mu zvracet.
to have a cough → kašlat
She’s twisted/spraied her akle. → Vyvrtla si kotík.
high/low blood pressure → ízký/vysoký kreví tlak
They have food poisoig. → Mají otravu jídlem.
swolle → ateklý, apuchlý
They ate some praws that were off. → Sědli krevety, které byly zkažeé.
paikillers → léky proti bolesti
atihistamie → atihistamia
to come roud → probrat se (z bezvědomí)
to get over flu → zbavit se chřipky
to (get better)/recover → zotavit se, uzdravit se
hypochodriac → hypochodr
a ureliable source of iformatio → espolehlivý zdroj iformací
to be out of date → být zastaralý
to reveal a serious problem → odhalit vážý problém
to discrimiate betwee commo ad rare coditios → rozlišovat mezi běžými a vzácými chorobami

17.2.XII

to cure a disease → léčit emoc
cofessio → přizáí
to feel uder the weather → cítít se špatě/emoce
diagosis → diagóza
GP/(geeral practitioer) → obvodí lékař
heart rate → tepová frekvece
cosolatio → utěšeí
obsessive → posedlý
the worst-case sceario → ejhorší scéář/případ
ECG/EKG/(electrocardiograph) → EKG
faulty → vadý
a life-threateig illess → život ohrožující emoc
to assume → předpokládat
mouth ulcer → aft
ulcer → vřed
to look up iformatio o the iteret → vyhledávat iformace a iteretu
to remove → odstrait
alterative remedy → alterativí léčba
miracle cure → zázračý lék
maligat → zhoubý

17.2.XIII

cell → buňka
bacteria → bakterie
medical treatmet → lékařské ošetřeí
health-related websites → webové stráky týkající se zdraví
eyesight → zrak
itchy → svědivý
healthcare → zdravotictví
asthma → astma
switch → vypíač/spíač
morphie → morfium
to itch → svědit
to get out of here → vypadout odsud
i the middle of owhere → v pustiě, uprostřed ičeho
frustrated → frustrovaý
to swear  → přísahat adávat
adveturous → dobrodružý
clumsy → ešikový
stubbor → tvrdohlavý
uethusiastic → eadšeý
vulerable → zraitelý

17.2.XIV

the elderly → seioři
stereotype → stereotyp
to coform to → vyhovovat, odpovídat ěčemu
documetary → dokumetárí film
documet → dokumet
wrikled ski → vrásčitá kůže
false teeth → umělý chrup
wig → paruka
cotact leses → kotaktí čočky
discomfort → epohoda
the physical problems of old age → tělesé obtíže vysokého věku
record → ahrávka
to record → ahrávat
They seem/appear to be old. → Zdá se, že jsou staří.
ivisibility → eviditelost
astoished → udiveý
to wolf-whistle → hvízdat
to treat sb → chovat se k ěkomu
to pay my fare with a large ote → platit jízdé velkou bakovkou
to break dow → zhroutit se

17.2.XV

to feel guilty → cítit se vie
to (go through)/experiece sth → zažít, prožít ěco
igorat → ezalý, evědomý
to deal with sth → zabývat se ěčím
to behave somehow towards sb → chovat se k ěkomu ějak
residetial/ursig home → (domov důchodců)/(pečovatelský ústav)
politicia → politik
sufficietly/eough → dostatečě
mea → lakomý
chios → plátěé kalhoty
series → seriál, série
fabulous → úžasý
ridiculous → směšý
middle-aged me → muži středího věku
Cogress approved the budget. → Kogres schválil rozpočet.
Her parets did’t approve of her boyfried. → Rodiče ji eschvalovali jejího přítele (esouhlasili, euzávali).
to take sth ito accout → vzít ěco v potaz
loose → volé
tight → těsé/přiléhavé
hooded → s kapucí

17.2.XVI

short/log sleeved → s krátkým/dlouhým rukávem
sleeveless → bez rukávu
V-eck → výstřih do V
checked → kostkovaé
pattered → se vzorem
plai → jedobarevý, bez vzoru
spotted → putíkovaý
striped → pruhovaý
stripped → svlečeý
vest → tílko
cotto → bavla
waistcoat → vesta
collar → límec
fur → kožich
top → svršek
lace  → krajka
lie → lěý
lycra → elastický
silk → hedvábí
scarf → šál

17.2.XVII

velvet → samet
bow tie → motýlek
wool/woole → vlěý
suede → semiš
scruffy → ošutělý
to dress up → vyšňořit se
to hag up your coat → pověsit si kabát
The jeas do’t fit me. → Džíy mi esedí.
The jeas do’t suit me. → Džíy mi esluší.
Your bag matches your shoes. → Taška ti ladí s botami.
to get chaged → převléci se
to get dressed/udressed → oblékout/svlékout se
The tie does’t go with your shirt. → Ta kravata ti ejde ke košili.
sales figures → (údaje o prodeji)/čísla
to criticize → kritizovat
to critique → hodotit
critic → kritik
critical  → kritický
doubt → pochybost
erve-rackig → (ervy drásající)/stresující

17.2.XVIII

iappropriately → evhodě
bluder → hloupá/zbytečá chyba kiks
iability → eschopost
schedule → rozvrh
distractio → rozptýleí
to fiddle with  → hrát/pohrávat si s
to take a sip of coffee → cucout si, usrkout si kávy
iexcusable → eomluvitelý
your prospective employer → váš poteciálí zaměstavatel
missio → posláí
stumped → zaraže, vyvede z míry
to focus o → zaměřit se a
to get sidetracked → mít odvedeou pozorost
to maitai a positive attitude → zachovat si pozitiví přístup/postoj
ca’t stad/bear sb/sth → emoci vystát
to leave the compay o bad terms → opustit firmu ve zlém
by heart  → azpaměť
addict → závislák
to glace at sth/sb → letmo pohlédout a
star sig → zameí zvěrokruhu

17.2.XIX

doze → tucet
The televisio chaels are devoted etirely to astrology. → Televizí staice jsou zcela věováy astrologii.
domestic crisis → krize v domácosti
to cope with → zvládout ěco, poradit si s ěčím
wellbeig → pocit pohody
walk of life → společeské postaveí
to be cosidered ufavourable → být považováo za epřízivé
to seek advice → vyhledat radu
to specialize i → specializovat se a
to provide busiess advice → poskytovat obchodí poradeství
prime miister → premiér
geeral electio → parlametí volby
to put up a tet → postavit sta
materity ward → porodické odděleí
delighted → velmi potěše
to chage people’s lives for the better → změit životy lidí k lepšímu
to advise → radit, poradit
advice → rada
therapist → terapeut
I ca’t afford to buy a car. → Nemůžu si dovolit koupit auto.

17.2.XX

flight attedat → stevard
They ever liste to her opiio. → Nikdy easlouchají jejímu ázoru.
He ever thiks of ayoe else. → Nikdy emyslí a ěkoho jiého.
He thiks a lot of himself. → Hodě si o sobě myslí.
She texted me last ight. → Napsala mi včera v oci zprávu.
I do’t feel like cookig. → Nechce se mi vařit.
to adhere to the terms of cotract → dodržet podmíky smlouvy
to state → uvést/říci
to complete/(fill i) a applicatio form → vyplit formulář žádosti
to buy/purchase → koupit
My cotract will termiate ext year. → Moje smlouva vyprší příští rok.
to verify → ověřit
We view your prospects of promotio as very high.  → Vímáme vaše šace a povýšeí jako velmi vysoké.
to be take o as a cleaer → být přijat jako uklízeč
to admit → přizat
to rage from - to - → (pohybovat se)/(být v rozmezí) od - do -
to spill a drik → rozlít ápoj
to update → aktualizovat
update → aktualizace
database → databáze

17.2.XXI

the verdict of the course case → rozsudek soudího řízeí
a high-profile case → ostře sledovaý případ
mix-up → přehmat/chyba
to approach sb → oslovit ěkoho
implicatios → důsledky
meawhile → mezitím
to broadcast → vysílat (TV, rozhlas)
spokesperso → mluvčí
to take a measure → učiit opatřeí
to esure → zajistit
to blik → mrkat
to decrease → klesat
to digest → strávit
adequate fluid itake → přiměřeý příjem tekuti
cosumptio → spotřeba
caffeiated driks → ápoje s kofeiem
scietific evidece → vědecké důkazy
to reiforce → posílit
a cliical trial → kliický test
ushave → eoholeý

17.2.XXII

dim light → (tlumeé světlo)/šero
ophthalmologist → očí lékař
permaetly  → trvale
to disprove a myth → vyvrátit mýtus
short-sighted people → krátkozrací lidé
later → svítila
drowsiess → ospalost
miced beef → mleté hovězí
She is allergic to cats. → Je alergická a kočky.
We have’t see each other for ages. → Neviděli jsme se celou věčost.
exhausted → vyčerpaý
bak holiday → státí svátek
I’ve moved out of my parets’ house. → Odstěhoval jsem se od rodičů.
sig laguage → zaková řeč
The ijured were take to hospital. → Zraěí byli převezei do emocice.
frequetly/ofte → často
to reject → odmítout
uiqueess → uikátost
If this appeals to you, ... → Jestli se ti toto líbí, ...
idispesable → epostradatelý

17.2.XXIII

leggigs → legíy
garmet → část oděvu
accessories → doplňky (módí)
to alter → změit
aversio → odpor
cosumerism → kozumí způsob života
cosumer society → kozumí společost
baggy trousers → pladavé, vytahaé kalhoty
to sew → šít
shed → kůla
shootig star → padající hvězda, meteor
forehead → čelo
to glow → žhout
to break the mould → změit stávající stav
to budle/wrap up → avlékout se (oblečeím)
to glitter  → třpytit se
automatic trasmissio → automatická převodovka
fireplace → krb
all-star cast → hvězdé obsazeí filmu
backstreet → bočí ulice

22.9.I

Sleepig Beauty → Šípková Růžeka
curtai → závěs/zácloa
blid/shade → roleta/žaluzie
shutters → okeice
log/short-haul flight → dálkový/krátký let
I used to play soccer. → Hrával jsem fotbal.
He was used to gettig up early. → Byl zvyklý vstávat brzy.
I have to get used to it. → Musím si a to zvykout.
lucid → jasý/(lehce srozumitelý)
fast/soud asleep → tvrdě spící
sleepwalker/somambulist → áměsíčý člověk
o the occasio → při této příležitosti
duvet → peřia
comforter → peřia
sleepig pills → léky a spaí
isomia → espavost
isomiac → člověk trpící espavostí
a recurrig dream → vracející se se
to stay up → zůstat vzhůru
to stay i → zůstat doma

22.9.II

striged istrumet → struý ástroj
cotact les solutio → roztok a očí čočky
salie solutio → solý roztok
gap year → rok vola po středí škole
medical assessmet → lékařský posudek
to sob → vzlykat
cattle → skot
kettle → kovice/kotlík
to deteriorate → zhoršit /se
assault/attack → útok
to ifuriate → rozčílit/rozzuřit
bill → účet
check → účet
plumber → istalatér
to be moved to tears → být dojat k slzám
to dagle → viset/(pohupovat se)
uihibited → bezprostředí/espoutaý
a outburst of ager → záchvat/výbuch hěvu
Proceed to gate 25. → Odeberte se k bráě 25.
to dimish → zmešit

29.9.

roudabout → kruhový objezd
traffic circle → kruhový objezd
'isult → urážka
i'sult → urazit
He is isesitive to her cryig. → Je lhostejý k jejímu pláči.
satav/(satellite avigatio) → satelití avigace
He ought to have told me earlier. → Měl mi to říci dříve.
My cell/mobile was o silet. → Měl jsem ztišeý telefo.
rotte wood → ztrouchivělé dřevo
They blamed me for the accidet. → Viili mě z té ehody.
They're blamig it o me. → Svádějí to a mě.
sugar cae → cukrová třtia
machete → mačeta
She lauche ito a tirade agaist her husbad. → Spustila moolog proti svému maželovi,
marriage cousellig → maželské poradeství
to withdraw sb/somebody from educatio → stáhout ěkoho ze vzděláváí
to raise/(brig up) the subject of moey → adhodit téma peěz

